[level]
map = ................
      .######.........
      .#######.###....
      .##..#######....
      .....######.....
      ................
      ................
      ................
      ................
      ................
      ................
      ................
      ................
      ................
      ................
      ................

[.]
name = sea
image = 16, 11

[#]
name = ground
has_border = 1
image = 1, 1